      211122222222222222222222222222222222222222222222222222222222222222222222222222222
      200000000000000000000000000000000000000000000000000000000000000000000000000022222
      200000000000000000000000000000000000000000000000000000000000000000000000000000002
      200002222222222222222222222222222222222222222222222222222222222222222222222200002
      200023111111111121111111113111112111111111113111111111112111111131111111111121112
      200231111111211111113111111111113111111111112111111111113111111121111121111111112
      222221122222222222222222222222222222222222222222222222222222222222222222222222222
      231111111111111111111111111111111111111111111111111111111111111111111111311111112
      211111311111111111111111111111111111111111111111111111111111111111111111111111132
      222222222222222222222222222222222222222111222222222222222222222222222222222222222